#font irrelevant
Adriatic Sea = adr adriatic
Aegean Sea = aeg aegean
Albania = alb
Ankara = ank
Apulia = apu
Armenia = arm
Baltic Sea = bal baltic
Barents Sea = bar barents
Belgium = bel
Berlin = ber
Black Sea = bla black
Bohemia = boh
Brest = bre
Budapest = bud
Bulgaria (east coast) = bul/ec bul(ec) bulgaria/ec bulgaria(ec)
Bulgaria (south coast) = bul/sc bul(sc) bulgaria/sc bulgaria(sc)
Bulgaria = bul
Burgundy = bur burgandy
Clyde = cly
Constantinople = con
Denmark = den
Eastern Mediterranean = eas emed east eastern eastmed ems eme emd eas+med
Edinburgh = edi
English Channel = eng english channel ech eng+ch
Finland = fin
Galicia = gal galacia
Gascony = gas
Greece = gre
Gulf of Lyon = lyo gol gulfofl lyon
Gulf of Bothnia = bot gob both gulfofb bothnia
Helgoland Bight = hel helgoland heligoland heligoland+bight
Holland = hol
Ionian Sea = ion ionian
Irish Sea = iri irish irs
Kiel = kie
Liverpool = lvp livp lpl
Livonia = lvn livo lvo lva
London = lon
Marseilles = mar mars
Mid-Atlantic Ocean = mao midatlanticocean midatlantic mid mat
Moscow = mos
Munich = mun
Naples = nap
North Atlantic Ocean = nao nat
North Africa = naf nora n+afr
North Sea = nth norsea nts
Norway = nwy nor norw
Norwegian Sea = nwg norwegian norwsea nrg norg
Paris = par
Picardy = pic
Piedmont = pie
Portugal = por
Prussia = pru
Rome = rom
Ruhr = ruh
Rumania = rum
Serbia = ser
Sevastopol = sev sevastapol
Silesia = sil
Skagerrak = ska
Smyrna = smy
Spain (north coast) = spa/nc spa(nc) spain/nc spain(nc) spn/nc spn(nc) spa+(north+coast)
Spain (south coast) = spa/sc spa(sc) spain/sc spain(sc) spn/sc spn(sc) spa+(south+coast)
Spain = spa spn
St Petersburg (north coast) = stp/nc stp(nc) stpete/nc stpete(nc) st.+petersburg/nc stp+(north+coast)
St Petersburg (south coast) = stp/sc stp(sc) stpete/sc stpete(sc) st.+petersburg/sc stp+(south+coast)
St Petersburg = stp stpete st.+petersburg st.petersburg
Sweden = swe
Syria = syr
Trieste = tri
Tunis = tun
Tuscany = tus
Tyrolia = tyr tyl trl tyo
Tyrrhenian Sea = tys tyrr tyrrhenian tyn tyh
Ukraine = ukr
Venice = ven
Vienna = vie
Wales = wal
Warsaw = war
Western Mediterranean = wes wmed west western westmed wms wme wmd west+med wes+med western+med
Yorkshire = yor york yonkers
Switzerland		= swi
